79 22
0000000000000000000000000000000000000000000000000000000000000000000000000000000
0000000000000000000000000000000000000000000000000000000000000000000000000000000
0000000567567670000000000000000000000000000000000000000000000000005675676700000
0000004564564564500000000000000000000000000000000000000000000000045645645645000
0000000004564564560000000000000000000000000000000000000000000000000045645645600
0000000456456000000000000000565000000000000000000000000000000000004564560000000
0000000456456456000000000056756560000000000000234000000000000000004564564560000
0000000000545650000000000245565676000000006786783450000000000000000005456500000
0000004560000000000000000000567670000000067867870325000000000000045600000000000
0000000000000000000000000000000000000000000678876468000000000000000000000000000
0000000000000000000000000000000000000000000000456560000000000000000000000000000
0000000000000000000000000000000000000000000000000000000000000000000000000000000
0000000000000000000000000003000000000000000000000000000000000000000000000000000
0000000000000000000008997897890000000000000000000000000000000000000000000000000
0000000000000000007898967896467897890000000000000000000000000000000000000000000
0000000000000000097897866668796789345896780000000000000005675675600000000000000
0000000000000000467867789567856786783457890000000000000676567567800000000000000
0000000000000035676587696478236867987567567000000017567578978978940000000000000
0000000065478679678536756767978976897456756750005797987987897789867773456700000
0000066543765787698756746745673456787676766567576678989878989789788476787800000
0000663567657867567356734576787896578356743566435677899878978989895555977877800
0005735675675467245767785678345765676786757675698887234234235656787777778888760
