171 69
000000000000000000000000000000000000000000000000000000000000000000000000000000000000000000000000000000000000000000000000000000000000000000000000000000000000000000000000000
000000000000000000000000000000000000000000000000000000000000000000000000000000000000000000000000000000000000000000000000000000000000000000000000000000000000000000000000000
000000000000000000000000000000000000000000000000000000000000000000000000000000000000000000000000000000000000000000000000000000000000000000000000000000000000000000000000000
000000000000000000000000000000000000000000000000000000000000000000000000000000000000000000000000000000000000000000000000000000000000000000000000000000000000000000000000000
000000000000000000000000000000000000000000000000000000000000000000000000000000000000000000000000000000000000000000000000000000000000000000000000000000000000000000000000000
000000000000000000000000000000000000000000000000000000000000000000000000000000000000000000000000000000000000000000000000000000000000000000000000000000000000000000000000000
000000000000000000000000000000000000000000000000000000000000000000000000000000000000000000000000000000000000000000000000000000000000000000045234534500000000000000000000000
000000000000000000000000000000000000000000000000000000000000000000000000000000000000000000000000000000000000000000000000000000000000000213412341234123400000000000000000000
000000000000000000000000000000000000000000000000000000000000000000000000000000000000000000000000000000000000000000000000000000000000012342342343453245345000000000000000000
000000000000000000000000000000000000000000000000000000000000000000000000000000452345345000000000000000000000000000000000000000000000000456456354635645600000000000000000000
000000000000000000000000000000000000000000000000000000000000000000000000002134123412341234000000000000000000000000000000000000000000000003453245334500000000000000000000000
000000000000000000000000000000000000000000000000000000000000000000000000123423423434532453450000000000000000000000000000000000000000000000002345000000000000000000000000000
000000000000000000000000000000000000000000000000000000000000000000000000004564563546356456000000000000000000000000000000000000000000000000000000000000000000000000000000000
000000000000000000000000000000000000000000000000000000000000000000000000000034532453345000000000000000000000000000000000000000000000000000000000000000000000000000000000000
000000000000000000000000000000000000000000000000000000000000000000000000000000023450000000000000000000000000000000000000000000000000000000000000000000000000000000000000000
000000000000000000000000000000000000000000000000000000000000000000000000000000000000000000000000000000000000000000000000000000000000000000000000000000000000000000000000000
000000000000000000000000000000000000000000000000000000000000000000000000000000000000000000000000000000000000000000000000000000000000000000000000000000000000000000000000000
000000000000000000000000000000000000000000000000000000000000000000000000000000000000000000000000000000000000000000000000000000000000000000000000000000000000000000000000000
000000000000000000000000000000000000000000000000000000000000000000000000000000000000000000000000000000000000000000000000000000000000000000000000000000000000000000000000000
000000000000000000004523453450000000000000000000000000000000000000000000000000000000000000000000000000000000000000000000000000000000000000000000000000000000000000000000000
000000000000000021341234123412340000000000000000000000000000000000000000000000000000000000000000000000000452345345000000000000000000000000000000000000000000000000000000000
000000000000001234234234345324534500000000000000000000000000000000000000000000000000000000000000000002134123412341234000000000000000000000000000000000000000000000000000000
000000000000000045645635463564560000000000000000000000000000000000000000000000000000000000000000000123423423434532453450000000000000000000000000000000000000000000000000000
000000000000000000345324533450000000000000000000000000000000000000000000000000000000000000000000000004564563546356456000000000000000000000000000000000000000000000000000000
000000000000000000000234500000000000000000000000000000000000000000000000000000000000000000000000000000034532453345000000000000000000000000000000000000000000000000000000000
000000000000000000000000000000000000000000000000000000000000000000000000000000000000000000000000000000000023450000000000000000000000000000000000000000000000000000000000000
000000000000000000000000000000000000000000000000000000000000000000000000000000000000000000000000000000000000000000000000000000000000000000000000000000000000000000000000000
000000000000000000000000000000000000000000000000000000000000000000000000000000000000000000000000000000000000000000000000000000000000000000000000000000000000000000000000000
000000000000000000000000000000000000000000000000000000000000000000000000000000000000000000000000000000000000000000000000000000000000000000000000000000000000000000000000000
000000000000000000000000000000000000000000000000000000000000000000000000000000000000000000000000000000000000000000000000000000000000000000000000000000000000000000000000000
000000000000000000000000000000000000000000000452345345000000000000000000000000000000000000000000000000000000000000000000000000000000000000000000000000000000000000000000000
000000000000000000000000000000000000000002134123412341234000000000000000000000000000000000000000000000000000000000000000000000000000000000000000000000000000000000000000000
000000000000000000000000000000000000000123423423434532453450000000000000000000000000000000000000000000000000000000000000000000000000000000000000000000000000000000000000000
000000000000000000000000000000000000000004564563546356456000000000000000000000000000000000000000000000000000000000000000000000000000000000000000000000000000000000000000000
000000000000000000000000000000000000000000034532453345000000000000000000000000067780000000000000000000000000000000000000000000000000000000000000000000000000000000000000000
000000000000000000000000000000000000000000000023450000000000000000000000000000755567867000000000000000000000000000000000000000000000000000000000000000000000000000000000000
000000000000000000000000000000000000000000000000000000000000000000000000000004467676756670000000000000000000000000000000000000000000000000000000000000000000000000000000000
000000000000000000000000000000000000000000000000000000000000000000000000000063675675675678000000000000000000000000000000000000000000000000000000000000000000000000000000000
000000000000000000000000000000000000000000000000000000000000000000000000000674355676575676670006870000000000000000000000000000000000000000000000000000000000000000000000000
000000000000000000000000000000000000000000000000000000000000000000000000007435567567567567657786787680000000000000000000000000000000000000000000000000000000000000000000000
000000000000000000000000000000000000000000000000000000000000000000000000065648767556487675566887545567450000000000000000000000000000000000000000000000000000000000000000000
000000000000000000000000000000000000000000000000000000000000000000000000068787556787875567567567878787566780000000000000000000000000000000000000000000000000000000000000000
000000000000000000000000000000000000000000000000000000000000000000000006765648767556487675566887567567565674500000000000000000000000000000000000000000000000000000000000000
000000000000000000000000000000000000000000000000000000000000000000000686855645768756457687654564675566887875600000000000000000000000000000000000000000000000000000000000000
000000000000000000000087878767860000000000000000000000000000000000007776676567768665677686786785687654565675686700000000000000000000000000000700000000000000000000000000000
000000000000000000000856756756747678600000000000000000000000000006066867664565756745657567564564876755668875455674500000000000000000000000000674500000000000000000000000000
000000000000000000056756756756756756658678670000000000000000000005648767555677777556777775675856487675566887545567456700000000000000000000080567456700000000000000000000000
077078787556756756564876755668875455674575676786700000000000000788787556756756787878756456575587564876755668875455674580000000000000000000090455674580000000000000000000000
856745648767556688878755675675678787875664534575486780000000007685648767556688756756756567777556878755675675678787875646786780000000000008999787875646786784566877865675677
564876755668875455564876755668875675675645567346777775000000067865645768765456467556688556475656564876755668875675675687545567450000000889088675675687545567456777745765756
878755675675678787564576876545646755668845567456487675570000086766567768678678568765456874565465564576876545646755668867878787566000000098808955668867878787565676545767567
564876755668875675656776867867856876545678787567567567576607856754565756756475668678678534545545656776867867856876545687567567567700000890798976545687567567567745676576889
564576876545646755456575675647566867867867567567345345756767567565677777567567656756475567456756456575675647566564876755668875455674500789887964876755668875455678999998787
656776867867856876567777756756765675647575566887648567564876755668875455674564876755668875455674567777756756765878755675675678787875667867878878755675675678787875667867878
456575675647566867867878756756756786785687654564575675878755675675678787875878755675675678787875687875567545657564876755656487675566887545567564876755656487675566887545567
567777756756765675647588754556745566887545567456755668875455674567556688754556756487675566887545648767556688754564576876587875567567567878787564576876587875567567567878787
878755675675678787875656787878756567567878787565675675678787875656756756787878787875567567567878787556756756787656776867856487675566887545567656776867856487675566887545567
564876755668875675675688756756756566887567567566755668875675675667556688756756756487675566887565648767556688756456575675687875567567567878787456575675687875567567567878787
656776867867856876545678568765456786785687654566867867856876545668678678568765465677686786785686567768678678568765456686756457687654564675566765456686756457687654564675566
456575675647566867867875668678678564756686786785675647566867867856756475668678645657567564756684565756756475668678678567565677686786785687654678678567565677686786785687654
567777756756765675647567656756475675676567564757756756765675647577567567656756456777775675676565677777567567656756475775645657567564756686786756475775645657567564756686786
456575675647566867867878756756756786785687654564575675878755675675678787875878755675675678787875687875567545657564876755656487675566887545567564876755656487675566887545567
567777756756765675647588754556745566887545567456755668875455674567556688754556756487675566887545648767556688754564576876587875567567567878787564576876587875567567567878787
878755675675678787875656787878756567567878787565675675678787875656756756787878787875567567567878787556756756787656776867856487675566887545567656776867856487675566887545567
564876755668875675675688756756756566887567567566755668875675675667556688756756756487675566887565648767556688756456575675687875567567567878787456575675687875567567567878787
564576876545646755668856467556688654564675566886876545646755668868765456467556656457687654564675645768765456467567777756756487675566887567567567777756756487675566887567567
656776867867856876545678568765456786785687654566867867856876545668678678568765465677686786785686567768678678568765456686756457687654564675566765456686756457687654564675566
456575675647566867867875668678678564756686786785675647566867867856756475668678645657567564756684565756756475668678678567565677686786785687654678678567565677686786785687654
567777756756765675647567656756475675676567564757756756765675647577567567656756456777775675676565677777567567656756475775645657567564756686786756475775645657567564756686786
